##########
#S   #   #
# ## # # #
#      #E#
##########