########
#S     #
# ### ##
#   #  #
### # ##
#     E#
## #####
########
