##########
#S   #   #
# ## # # #
#    # #E#
##########