###############################
#S    #       #   #   #     # #
### # ### ### ### ### ### ### #
#   #     #   #   #   #   #   #
# ####### ### ### ### ### #####
# #     #     #     #     #   #
# # ### ##### ### ##### ### # #
# #   #     # #   #   #     # #
# ### ### # # ### # # ##### ###
#   #   # #   #   # #     #   #
### # # # ##### ##### # # # ###
# # # # #####   ### ### # # # #
#     #       #         #   # #
### ### ### ########### ###  E#
###############################
